zulya	NOUN
Zölfiä	NOUN
yünendä	ADV
yoldızları	ADJ
yılnıñ	NOUN
yıllarındağı	NOUN
yıllarında	NOUN
yıllarına	NOUN
yıllardağı	NOUN
yılda	NOUN
yıl	NOUN
yazılğan	ADJ
yäşäwçe	VERB
yaqın	ADJ
yäki	NOUN
xalqı	NOUN
xalıqara	ADJ
xäbär	NOUN
www	OTHER
Wikipediä	NOUN
waqıttan	NOUN
wä	CCONJ
v	CCONJ
üze	PRON
üz	PRON
uylap	VERB
ütkän	ADJ
ütä		ADV
üsterüenä	VERB
üsterü	VERB
üseşendä	NOUN
üseşe	NOUN
urtası	NOUN
ul	PRON
turında	SCONJ
tulısınça	ADV
tt	OTHER
TRnıñ	OTHER
TR	OTHER
totılğan	ADJ
törle	ADJ
Törkiädä	NOUN
törki	NOUN
torğan	VERB
TMG	OTHER
tiräsendä	ADV
tigezle	ADJ
tieşle	ADJ
texnoloğiäläre	NOUN
texnoloğiälärdä	NOUN
texnoloğiälär	NOUN
tellärendäge	NOUN
tellärendä	NOUN
tellären	NOUN
telläre	NOUN
tellär	NOUN
teleneñ	NOUN
telendäge	NOUN
telen	NOUN
tele	NOUN
Täwge	ADJ
Tatnet	NOUN
Tatmedia	NOUN
Tatarstan	NOUN
tatarlıqqa	NOUN
Tatarları	NOUN
Tatarlar	NOUN
tatarlar	NOUN
tatarı	NOUN
tatari	NOUN
Tatarça	ADJ
Tatar	ADJ
tatar	ADJ
taratqıçın	NOUN
tarafınnan	PRON
tağın	ADV
tä	OTHER
ta	OTHER
Şuşı	PRON
Şunnan	ADV
şul	PRON
ştatları	NOUN
standartların	NOUN
ssu	OTHER
şriftların	NOUN
söylämen	VERB
soñ	ADV
sizep	VERB
sistemnarın	NOUN
sistemı	NOUN
sintaqsis	NOUN
seti	NOUN
serverı	NOUN
saytların	NOUN
saytları	NOUN
saytı	NOUN
sayt	NOUN
säyäsäten	NOUN
saqlaw	NOUN
sanı	NOUN
sanaq	NOUN
samara	NOUN
Samar	NOUN
sala	VERB
Sabirjan	NOUN
ru	OTHER
resurslarnıñ	NOUN
resursların	NOUN
resurslar	NOUN
Respublikınıñ	NOUN
Respublikındağı	NOUN
Respublikı	NOUN
Respublikasındağı	NOUN
Respublikasında	NOUN
Respublikası	NOUN
räweştä	NOUN
räsmi	ADJ
Räsäydäge	NOUN
radiosınıñ	NOUN
radiosında	NOUN
radiosı	NOUN
qullanuçılar	VERB
qullanu	VERB
qızıqlı	ADJ
Qazanda	NOUN
Qazan	NOUN
qatnaşqan	VERB
Qararına	VERB
Qanunı	NOUN
qanunda	NOUN
qanatı	NOUN
Qamal	NOUN
qağılışlı	VERB
qabul	NOUN
proğramnarın	NOUN
proğramması	NOU
proğrammada	NOUN
proğramma	NOUN
proektların	NOUN
proektlar	NOUN
proektı	NOUN
Prezidentı	NOUN
povolzje	NOUN
portalı	NOUN
päräwez	NOUN
öyränü	NOUN
oyıştırılğan	VERB
org	OTHER
ölkälärendäge	NOUN
öleş	NOUN
oktäberendä	NOUN
öçen	CCONJ
nıñ	PRON
nigezlären	NOUN
Nigezläre	NOUN
nigez	NOUN
net	OTHER
morfoloğiä	NOUN
moñ	NOUN
modellären	NOUN
modelen	NOUN
ministrılığında	NOUN
Milli	NOUN
milläte	NOUN
martında	NOUN
Mail	NOUN
mäğlümatlaştıruın	VERB
mäğlümatlaştıru	VERB
mäğlümati	NOUN
küzdä	NOUN
kürä	VERB
küp	VERB
kübese	NOUN
köy	NOUN
kongressı	NOUN
kongress	NOUN
konferensiäse	NOUN
Komplekslı	NOUN
kilä	VERB
kiçergän	ADJ
kibete	NOUN
kertü	VERB
kcn	OTHER
kämilläşterü	ADJ
IV	OTHER
itü	ADJ
itelgän	ADJ
itä	VERB
isemle	ADJ
isäptä	NOUN
isäpkä	NOUN
intl	OTHER
İntertat	OTHER
intertat	OTHER
İnternetı	NOUN
İnternet	NOUN
internet	NOUN
iñ	PART
III	OTHER
II	OTHER
ide	VERB
http	OTHER
htm	OTHER
härkem	PRON
häm	INTJ
h	INTJ
Group	NOUN
Google	NOUN
google	NOUN
ğömer	NOUN
ğinwarında	NOUN
gäzite	NOUN
ğämäli	NOUN
Forumnarı	NOUN
Forumı	NOUN
fonoloğiä	NOUN
fiker	NOUN
fayllar	NOUN
Fänni	NOUN
ezläwen	NOUN
ezläw	NOUN
eşläwen	NOUN
eşläp	VERB
eşlägän	VERB
eşkärtü	VERB
Elemtä	NOUN
elemtä	NOUN
Elektron	NOUN
elektron	NOUN
elek	NOUN
eçenä	ADV
e	INTJ
Dulqın	NOUN
draywer	NOUN
dönya	NOUN
Däwlät	NOUN
däwlät	NOUN
däwat	NOUN
däwam	NOUN
daimi	ADJ
da	OTHER
çorına	NOUN
com	OTHER
citärlek	NOUN
cırçı	NOUN
çığaruın	NOUN
çığarıla	NOUN
çeltärendäge	NOUN
çeltärendä	NOUN
çeltären	NOUN
buyınça	ADV
bulışu	VERB
bulğannarı	ADJ
bulğan	VERB
bülengän	ADJ
buldıruı	VERB
buldıruçılarnıñ	NOUN
buldıru	VERB
buldıra	VERB
bula	VERB
Bötendönya	NOUN
borılış	NOUN
Bit	PART
bik	ADV
bergä	ADV
Berençe	NUM
berençe	NUM
belän	SCONJ
Bedretdin	NOUN
bäygese	NOUN
Bäygedä	NOUN
başqalar	PRON
başqa	PRON
başlıy	VERB
başlap	VERB
başlanğan		ADJ
başlağan	ADJ
barlıqqa	VERB
barlığı	VERB
barısı	PRON
b	OTHER
Azatlıq	NOUN
azatliq	NOUN
ayırım	NOUN
äwerelä	ADJ
ataması	NOUN
astında	ADV
arta	ADV
arada	CCONJ
AQŞ	OTHER
Aqidel	NOUN
aprelendä	NOUN
Annarı	ADV
Alxan	NOUN
alu	NOUN
almaşu	VERB
alışuı	VERB
alıp	VERB
alğan	VERB
alarnı	PRON
akidil	NOUN
ağentlığın	NOUN
ağentlığı	NOUN
açıluı	VERB
açılğan	ADJ
.	PUNCT
,	PUNCT
?	PUNCT
!	PUNCT
(	PUNCT
)	PUNCT
:	PUNCT
;	PUNCT
"	PUNCT